42 42 42 42 42 42 42 42 42 10 42 42
17 17 2 42 42 42 42 42 42 10 42 42
42 42 10 42 38 39 40 42 42 10 42 42
42 42 3 17 5 51 3 17 17 7 2 42
42 42 11 42 44 45 46 42 42 42 10 42
42 42 42 42 42 42 42 42 42 42 10 42
17 17 17 17 17 1 17 17 17 17 8 42
42 42 42 42 42 10 42 42 42 42 42 42
42 42 42 42 42 10 42 42 42 42 42 42
42 42 42 42 42 10 42 42 42 42 42 42
42 42 42 42 42 10 42 42 42 42 42 42
42 42 42 42 42 10 42 42 42 42 42 42